SWWWWWWWWWWWWWWWWWWWWWWW=
S~~~~~~~~~~~~~~~~~~~~~~~=
S~~~~~~~~~~~~~~~~~~~~~~~=
SWWWWWWWW~~~~~~~~~~~~~~~=
S~~~~~~~~~~~~~~~~~~~~~~~=
S~~~~~~~~~~~~~~~~~~~~~~~=
S~~~~~~~~~~WWWWWWWWWWWWW=
S~~~~~~~~~~~~~~~~~~~~~~~=
S~~~~~~~~~~~~~~~~~~~~~~~=
SWWWWWWWWWWWWWWWWWWWWW~~=
S~~~~~~~~~~~~~~~~~~~~~~~=
S~~~~~~~~~~~~~~~~~~~~~~~=
S~~WWWWWWWWWWWWWWWWWWWWW=
S~~~~~~~~~~~~~~~~~~~~~~~=
S~~~~~~~~~~~~~~~~~~~~~~~=
SWWWWWWWWWWWWWWWWW~~WWWW=
S~~~~~~~~~~~~~~~~~~~~~~~=
S~~~~~~~~~~~~~~~~~~~~~~~=
SGGGGGGGGGGGGGGGGGGGGGGG=