Q 0 0 1 0
W 1 0 1 0
E 2 0 1 0
R 3 0 1 0
T 4 0 1 0
Y 5 0 1 0
U 6 0 0 0
I 7 0 0 0
O 8 0 0 0
P 9 0 0 0
A 0 0 1 0
S 0 1 1 0
D 0 2 1 0
F 0 3 1 0
G 0 4 1 0
H 2 4 1 0
J 3 4 1 0
K 4 4 1 0
L 5 4 1 0
; 3 5 1 0
Z 0 5 1 0
X 1 4 1 0
C 2 5 1 0
V 3 5 1 0
B 4 5 1 0
N 5 5 1 0
- 5 0 1 0
= 5 1 1 0
) 5 2 1 0
( 5 3 1 0
* 5 4 1 0
M 6 6 1 0
, 7 6 1 0
_ 7 4 1 0
+ 7 5 1 0
/ 8 4 1 0
\ 8 5 1 0
. 7 3 1 0
# 9 3 0 0
@ 9 9 0 0
! 8 9 0 0
" 6 3 1 0