T 3 0 1 0
B 1 4 1 0
L 0 1 1 0
R 5 1 1 0
. 4 1 0 0
F 0 9 1 0
C 0 4 1 0
O 5 4 1 0