Q 4 1 1 0
W 3 0 0 0
E 0 1 1 0
R 1 1 1 0
T 2 1 1 0
Y 3 1 1 0
U 0 2 1 0
I 1 2 1 0
O 2 2 1 0
P 3 2 1 0
A 0 3 0 0
S 1 3 0 0
D 2 3 0 0
F 3 3 0 0
G 6 6 0 0
H 0 9 1 0
J 1 9 1 0
) 4 9 1 0
K 7 9 1 0
L 7 10 1 0
Z 2 4 1 0
X 8 0 1 0
C 9 0 1 0
V 10 0 1 0
B 8 1 1 0
N 9 1 1 0
M 10 1 1 0
! 8 2 1 0
@ 9 2 1 0
# 10 2 1 0
$ 8 3 1 0
% 9 3 1 0
^ 10 3 1 0
& 2 5 0 0
* 2 6 0 0
( 2 7 0 0


